MAP
####################^^#####
####################..#####
##################.....####
###############|,|.....####
######|,|,|,|,|,|,...######
#####|,|,|......###########
####|,|,|..################
####,|...##################
###,|....##################
###|....###################
###....###########........>
##....##########,|,.......>
#.....#########,|,|##...###
#.....#######|,|,|,.##..###
#......#####|,|,|,....#####
#.##...###,|,|,|,....|#####
##..................|,#####
###...........##....,|,####
####...........##.|,|,|,###
####.............|,|,######
####|,|,|,|....,|,|,#######
#####|,|,|,|,|,|,|,########
#########.|,|,|,###########
###########################
###########################
###########################
END

NAME
The Forest

ASCIIMON
ID
10
WEIGHT
10
LEVEL RANGE
2 5
END

ASCIIMON
ID
12
WEIGHT
5
LEVEL RANGE
2 4
END