MAP
###########################
#,|,|,|,|,|,|,|,|,|,|.....#
#,|,|,|,|,|,|,|,|,........#
#,|,|,|,|,|...............#
#.........................#
#.........................#
#.........................#
#.........................#
#.........................#
#.............#|,|,|......#
#.............#|,|,|......>
#.............#|,|,|......>
#.........................#
#.........................#
#.........................#
#.........................#
#.........................#
#.........................#
#.........................#
#.........................#
#.........................#
#.........................#
#.........................#
#.........................#
#.........................#
###########################
END

NAME
Route 1

ASCIIMON
ID
0
WEIGHT
10
LEVEL RANGE
2 4
END
