MAP
##################################
#####################........#####
####...........................###
##............###................#
##............###................#
##...........###...............###
#............###...............###
#............##.................##
#............#.................###
##.............................###
##.............................###
##........................#....###
##.............................###
##.............................###
##........#....................###
#####........................#####
#####........................#####
######..............#........#####
##########.........###############
##################################
END
