NAME
Route 2
END

MAP
########################################
##.........##########.............######
<.............,|,|,|,|,|,,|,.........###
#..........,|,|,|,|,|,|,||,|..........##
####......#####|,|,|,|,|,,............##
##################,|,|.................>
################,|,|............########
#########,|,|,|,|,|.........############
######,|,|,|,|,|.......#################
#####,|,|,|,.........###################
####,|,|,|,........#####################
###,|,|,|,|,|,|,|#######################
<,|,|,|,|,|,|,|#########################
<,|,|,|,|,|,############################
#####,|,|,##############################
########################################
END
